
SwitchBlade layout

┌────────┬────────┬────────┬────────┬────────┐
│  DK_6  │  DK_7  │  DK_8  │  DK_9  │ DK_10  │
│        │        │        │        │        │
│ Online │ Offline│  Next  │Previous│Shutdown│
├────────┼────────┼────────┼────────┼────────┤
│  DK_1  │  DK_2  │  DK_3  │  DK_4  │  DK_5  │
│        │        │        │        │        │
│  Home  │ Friends│        │        │        │
└────────┴────────┴────────┴────────┴────────┘
┌────────────────────────────────────────────┐
│                                            │
│                                            │
│                                            │
│                                            │
│                                            │
│                                            │
│                                            │
│                                            │
│                                            │
│                                            │
│                                            │
│                                            │
└────────────────────────────────────────────┘
